1111111111111111111111111
1P0CCCCCCCCC00000CC000001
100C1111111C0000C11C00001
100CCCC1CCCC000C1001C0001
100000C1C00000C100001C001
100000C1C00000C111111C001
100000C1C00000C1CCCC1C001
100000C1C00000C1C00C1C001
100000CCC00000CCC00CCC0E1
1111111111111111111111111