11111111111111111111111111
1E000000000000000000000001
1000000000C1C0000CC11CC001
10000000C1C0000C1C00001C01
100000C1C0C1C0000000C1C001
1000C1C00C1C000000C1C00001
10CC11CC11CC1000C1C0000001
1000000C1C0000C1C000000001
100000C1C000C11CC11C000001
100000000000000000000000P1
11111111111111111111111111