11111111111111111111111111
1E000000000000010000000001
1000000000CCC0000CCCCCC001
10010000CCC0000CCC0000CC01
100000CCC0CCC0000000CCC001
1000CCC00CCC000000CCC00001
10CCCCCCCCCCC000CCC0000101
1000000CCC0000CCC000000001
100100CCC000CCCCCCCC010001
100000000000000000000000P1
11111111111111111111111111
