1111111111111
10C10000C0001
1100010111C01
100010E0010P1
1111111111111